AQUIDABA -> MURIBECA || CANHOBA

ARAUA -> ITABAIANINHA || ESTANCIA

AREIA BRANCA -> LARANJEIRAS || RIACHUELO || MALHADOR || ITABAIANA

BARRA DOS COQUEIROS -> PIRAMBU || ARACAJU

BOQUIM -> PEDRINHAS || SALGADO || LAGARTO || ARAUA || ITABAIANINHA

BREJO GRANDE -> PACATUBA

CAMPO DO BRITO -> LAGARTO || MACAMBIRA || ITABAIANA || 

CANINDE DE SAO FRANCISCO -> POCO REDONDO

CAPELA -> SIRIRI || AQUIDABA || MURIBECA || JAPARATUBA

CEDRO DE SAO JOAO -> TELHA || PROPRIA || SAO FRANCISCO || AQUIDABA

CRISTINAPOLIS -> ITABAIANINHA || UMBAUBA || TOMAR DO GERU

CUMBE -> FEIRA NOVA || AQUIDABA || CAPELA

DIVINA PASTORA -> MARUIM || RIACHUELO || SIRIRI

FREI PAULO -> RIBEIROPOLIS || CARIRA

GARARU -> PORTO DA FOLHA

GRACHO CARDOSO -> FEIRA NOVA || CUMBE || AQUIDABA || ITABI || GARARU

ILHA DAS FLORES -> BREJO GRANDE || PACATUBA || NEOPOLIS

INDIAROBA -> CRISTINAPOLIS || UMBAUBA || SANTA LUZIA DO ITANHY || ESTANCIA

ITABAIANA -> MALHADOR || RIBEIROPOLIS || FREI PAULO

ITABI -> GARARU || CANHOBA

ITAPORANGA D'AJUDA -> SALGADO || ESTANCIA || ARACAJU || SAO CRISTOVAO || AREIA BRANCA || CAMPO DO BRITO || LAGARTO

JAPARATUBA -> PIRAMBU || MURIBECA

JAPOATA -> NEOPOLIS || PROPRIA || PIRAMBU || JAPARATUBA

MACAMBIRA -> PEDRA MOLE || LAGARTO || FREI PAULO || ITABAIANA

MARUIM -> LARANJEIRAS

MOITA BONITA -> RIACHUELO || MALHADOR || ITABAIANA || RIBEIROPOLIS

MONTE ALEGRE DE SERGIPE -> NOSSA SENHORA DA GLORIA

NEOPOLIS -> PROPRIA

NOSSA SENHORA APARECIDA -> CARIRA || FREI PAULO || RIBEIROPOLIS || SAO MIGUEL DO ALEIXO

NOSSA SENHORA DA GLORIA -> CARIRA || NOSSA SENHORA APARECIDA || SAO MIGUEL DO ALEIXO || FEIRA NOVA || GRACHO CARDOSO || GARARU

NOSSA SENHORA DAS DORES -> CUMBE || CAPELA || SIRIRI || DIVINA PASTORA || RIACHUELO || MOITA BONITA || RIBEIROPOLIS || SAO MIGUEL DO ALEIXO || FEIRA NOVA

NOSSA SENHORA DE LOURDES -> GARARU || ITABI || CANHOBA

NOSSA SENHORA DO SOCORRO -> SAO CRISTOVAO || ARACAJU || SANTO AMARO DAS BROTAS || LARANJEIRAS

PACATUBA -> PIRAMBU || JAPOATA || NEOPOLIS

PEDRA MOLE -> PINHAO || LAGARTO || FREI PAULO

PEDRINHAS -> ITABAIANINHA || ARAUA

PINHAO -> FREI PAULO || CARIRA

POCO REDONDO -> PORTO DA FOLHA || MONTE ALEGRE DE SERGIPE

POCO VERDE -> SIMAO DIAS

PORTO DA FOLHA -> MONTE ALEGRE DE SERGIPE || GARARU

RIACHAO DO DANTAS -> LAGARTO || BOQUIM || ITABAIANINHA

RIACHUELO -> MALHADOR || LARANJEIRAS

ROSARIO DO CATETE -> MARUIM || DIVINA PASTORA || SIRIRI || CAPELA || PIRAMBU

SALGADO -> LAGARTO || ESTANCIA

SANTA LUZIA DO ITANHY -> ITABAIANINHA || ARAUA || ESTANCIA 

SANTANA DO SAO FRANCISCO -> NEOPOLIS

SANTO AMARO DAS BROTAS -> LARANJEIRAS || MARUIM || ROSARIO DO CATETE || PIRAMBU || BARRA DOS COQUEIROS

SAO CRISTOVAO -> ARACAJU

SAO FRANCISCO -> MURIBECA || JAPOATA || PROPRIA

SAO MIGUEL DO ALEIXO -> FEIRA NOVA || RIBEIROPOLIS

SIMAO DIAS -> LAGARTO || RIACHAO DO DANTAS || PEDRA MOLE || PINHAO

TELHA -> CANHOBA || PROPRIA

TOBIAS BARRETO -> ITABAIANINHA || RIACHAO DO DANTAS || SIMAO DIAS || POCO VERDE

TOMAR DO GERU -> TOBIAS BARRETO || ITABAIANINHA

UMBAUBA -> ITABAIANINHA || SANTA LUZIA DO ITANHY